11111111111111111111111111
10000P0000E0C00C0010000001
11111111111111111111111111